0 0 0 0 0 1 1 1 1 1 1 4 2 2 6 1 
0 1 1 1 0 1 1 1 1 1 1 4 2 2 6 1 
0 1 1 1 1 1 1 1 1 1 1 4 2 2 6 1
0 1 1 1 0 1 1 1 1 1 3 2 2 6 1 1
0 0 0 0 0 1 1 1 1 3 2 2 6 1 1 1
1 1 1 1 1 1 1 1 3 2 2 6 1 1 1 1
1 2 2 2 1 1 1 3 2 2 6 1 1 1 1 1
1 2 2 2 1 1 4 2 2 6 1 1 1 1 1 1
1 2 2 2 1 1 4 2 2 6 1 1 1 1 1 1
1 1 1 1 1 1 4 2 2 6 1 1 1 1 1 1
1 1 1 1 1 1 5 2 2 7 1 1 1 1 1 1
3 3 3 3 3 3 3 2 2 3 3 3 3 3 3 3